
MAZE: "test_level", ' '
FLAGS:premapped
GEOMETRY:center,center

MAP
||||||||||         
|........|         
|........|         
|.%.).[..|         
|........||||||||||
|.................|
|.................|
|.................|
|.................|
|.................|
|.................|
|.................|
|........||||||||||
|........|         
|.......||         
|.......|          
|.......|          
|.......|          
|.......|          
|.......|          
|||||||||          
ENDMAP

STAIR:(16, 6),down
BRANCH: (4,17,4,17),(5,18,5,18)
MONSTER: random, random, (4,1)
MONSTER: random, random, (16,10)
